4 4 4 4 4 4 4 4 4 4 4 4 4 4 4 4
4 4 13 4 4 4 4 4 4 4 15 4 4 4 4 4
4 4 48 49 49 49 49 49 49 49 49 49 49 50 4 13
4 4 53 54 54 54 54 54 54 30 54 54 54 55 4 4
14 4 53 30 36 36 47 36 36 36 36 36 54 55 4 4
4 4 53 54 36 36 36 36 36 36 45 36 29 55 4 4
4 4 53 20 36 45 36 36 45 36 36 36 54 55 4 4
4 4 53 20 36 36 36 36 36 36 36 46 54 55 4 14
4 4 53 54 54 54 31 54 54 54 31 54 54 55 4 4
4 4 58 59 59 59 59 59 59 59 59 59 59 60 4 4
15 4 4 4 4 4 4 4 4 4 14 4 4 4 13 4
4 4 4 4 4 4 4 4 4 4 4 4 4 4 4 4
