4 4 14 13 4 13 4 4 4 4 4 4 4 4 4 4 4 4 4 4 4 4 4 4 4 4 4 4 4 4 4 4 13 4 4 4 4 4 4 4 4 4 14 4 4 4 4 4 4 4
4 14 4 4 4 4 4 4 13 4 4 13 4 4 4 13 4 4 4 4 4 4 4 14 4 4 15 4 4 4 4 4 15 4 4 4 13 15 4 13 14 4 4 15 4 14 4 4 4 4
4 13 4 4 4 4 4 4 4 4 4 4 14 4 4 4 4 4 13 4 4 4 13 4 4 4 4 4 4 4 14 4 4 4 4 4 4 4 4 4 4 4 4 4 4 4 4 4 4 4
4 4 9 7 7 7 10 4 4 4 4 4 4 4 4 4 4 4 4 4 14 4 4 15 4 9 7 7 7 7 7 7 7 7 7 7 7 7 7 7 7 7 7 7 10 4 4 13 14 4
4 14 5 36 36 36 3 4 4 4 13 4 14 4 4 4 4 4 13 4 4 4 4 4 4 5 16 17 17 17 17 17 17 17 17 17 17 17 17 17 18 36 36 36 6 10 4 4 4 4
4 4 5 36 36 36 3 4 4 4 4 4 4 4 4 4 4 13 4 4 4 4 4 4 4 5 19 31 20 20 20 20 20 20 29 20 20 20 20 31 21 36 36 36 36 3 4 13 4 4
13 4 5 36 36 36 3 14 13 4 4 4 4 13 14 4 4 4 15 13 4 14 4 13 4 5 19 20 29 20 20 30 20 20 20 20 20 29 20 20 21 36 46 36 36 3 4 4 14 4
4 4 11 1 1 1 12 4 4 4 4 4 4 15 4 4 4 4 4 4 4 4 4 4 4 5 22 23 23 23 23 23 23 23 23 23 23 26 20 20 21 36 36 36 36 3 4 4 15 4
4 4 4 4 4 4 4 4 4 4 4 4 4 4 4 14 15 4 4 4 4 13 4 14 4 11 1 1 2 36 36 36 36 36 36 36 36 19 20 20 21 36 36 36 36 3 4 13 4 4
14 4 4 4 4 4 4 4 4 4 13 4 4 4 4 4 4 13 4 4 4 4 4 4 4 4 4 4 5 36 36 36 36 36 46 36 36 19 20 30 21 36 36 46 36 3 4 14 4 4
4 4 4 4 4 14 4 4 4 4 15 4 4 13 4 4 4 4 4 13 4 14 4 4 4 15 4 4 5 46 36 36 36 36 36 36 36 19 20 20 21 36 36 36 36 3 4 4 4 4
4 14 4 4 13 13 4 4 4 15 4 4 4 14 4 4 4 4 4 4 4 4 4 4 4 4 14 4 5 36 36 36 36 46 36 36 36 19 20 20 21 36 46 36 36 3 4 4 13 4
4 4 15 4 4 4 4 4 4 13 4 4 15 4 4 4 4 4 4 15 4 9 7 7 7 7 7 7 8 36 36 36 36 36 36 47 36 19 20 29 21 36 36 36 46 3 4 4 4 4
13 4 4 4 4 4 4 4 4 4 4 4 4 4 4 13 4 15 4 4 4 5 36 36 46 36 36 36 36 36 36 46 36 36 47 36 36 19 20 20 21 36 45 36 36 3 4 15 14 4
4 13 4 4 4 13 4 4 4 4 4 13 4 4 4 4 4 4 4 4 4 5 36 36 36 36 46 36 36 46 36 36 36 36 36 36 36 19 20 20 21 36 36 36 36 3 4 4 4 4
4 14 4 4 4 4 4 13 4 4 4 15 4 4 4 14 4 4 4 4 4 5 36 36 36 36 36 36 36 36 46 36 36 47 46 36 36 19 29 20 21 36 36 36 36 3 4 4 4 4
4 4 4 4 14 4 4 13 4 15 4 4 4 4 4 4 4 4 4 4 4 5 36 36 36 46 36 36 36 36 36 36 36 36 36 36 36 19 20 20 21 36 36 45 36 3 4 13 4 4
15 4 4 4 15 4 4 4 4 4 4 4 4 9 7 7 7 7 7 7 7 8 36 41 39 42 36 16 17 17 17 17 17 17 17 17 17 28 20 20 21 36 36 36 36 3 4 4 4 14
4 13 4 4 4 4 4 4 4 4 4 4 4 5 36 36 36 36 36 36 36 36 36 37 36 35 36 19 20 20 20 20 20 31 20 20 20 20 30 20 21 47 36 36 36 3 4 4 4 4
4 4 4 4 13 4 4 4 4 4 4 4 4 5 36 36 36 36 36 36 36 36 36 37 36 35 36 19 20 30 20 20 20 20 20 20 20 20 20 20 21 41 39 39 42 3 4 15 4 13
4 4 4 4 14 4 4 9 7 7 7 7 7 8 36 36 45 36 36 46 36 41 39 40 46 35 36 19 20 20 25 23 23 23 23 23 23 23 23 23 24 37 36 36 35 3 4 4 4 4
4 4 4 4 4 4 4 5 36 36 36 36 36 36 36 36 36 36 36 36 36 37 36 36 36 35 36 19 20 29 21 36 36 36 36 36 41 39 39 39 39 40 36 36 35 3 4 4 4 4
4 4 4 4 4 4 15 5 36 36 45 36 36 36 36 45 36 36 46 36 36 37 36 46 36 35 36 19 20 20 21 36 36 36 36 36 37 36 36 36 36 36 46 36 35 3 4 4 4 14
4 4 4 4 4 4 4 5 36 36 36 36 36 36 36 36 36 36 36 36 36 37 36 36 46 35 36 19 29 20 21 36 41 39 39 39 40 36 36 47 36 46 36 36 35 3 4 4 13 4
13 14 14 4 13 4 4 5 36 16 17 17 17 17 17 17 17 17 17 18 36 43 33 33 33 44 36 19 20 20 21 36 37 36 36 46 36 36 36 36 36 36 36 36 35 3 4 15 4 4
4 4 4 4 15 4 4 5 36 19 20 20 20 20 20 20 20 20 31 21 36 36 36 36 36 36 36 19 20 30 21 36 43 33 33 33 33 33 33 33 33 33 33 33 44 3 14 4 4 4
4 4 4 4 4 4 4 5 36 19 20 20 20 20 20 30 20 20 20 27 17 17 17 17 17 17 17 28 20 20 21 36 36 36 36 36 36 36 36 36 36 36 36 36 36 3 4 4 4 4
4 4 4 4 4 4 4 5 36 22 23 23 23 23 23 23 26 20 20 20 20 30 20 20 20 20 20 20 20 20 27 17 17 17 17 17 17 17 18 36 36 36 36 36 36 3 4 13 4 4
4 4 4 14 4 4 4 5 36 36 36 36 36 36 36 36 19 29 20 20 20 20 20 20 29 20 20 30 20 20 20 20 20 20 29 20 20 20 21 36 36 36 36 36 36 3 4 15 4 4
13 4 4 4 4 13 4 5 36 36 36 46 36 36 36 36 22 23 23 23 23 23 23 23 23 23 26 20 20 31 25 23 23 23 23 23 26 20 21 36 36 36 36 36 36 3 4 4 4 4
4 4 15 4 4 4 4 11 1 1 1 1 1 1 1 2 36 36 36 36 36 36 36 36 36 36 19 20 20 20 21 36 36 36 36 36 19 20 21 36 36 36 36 36 36 3 4 4 4 4
4 14 4 4 4 14 4 4 4 4 4 4 4 4 14 5 36 36 36 36 47 36 47 36 36 36 19 20 20 20 21 36 36 36 36 36 19 31 27 17 17 17 18 36 36 3 14 4 13 4
4 4 4 4 4 4 4 4 14 4 14 13 4 4 4 5 36 47 36 36 36 36 36 36 36 36 19 29 20 20 21 36 36 36 36 36 19 20 20 30 20 31 21 36 36 3 4 4 4 4
4 14 4 13 4 4 13 4 4 4 4 4 15 4 4 5 36 36 36 36 0 1 1 1 2 36 19 20 31 20 21 36 36 46 36 45 22 23 23 23 23 23 24 36 36 3 4 4 14 4
14 4 4 4 4 4 15 4 4 15 4 4 4 4 4 5 36 36 36 36 3 4 4 4 5 36 19 20 20 20 21 36 45 36 36 36 36 36 36 36 36 0 1 1 1 12 4 13 15 4
4 13 4 14 4 4 4 4 4 4 4 4 14 4 4 5 36 47 36 36 3 4 15 4 5 36 19 20 20 30 21 36 36 36 45 36 36 36 36 36 36 3 4 4 4 4 4 4 4 4
4 4 14 4 4 4 4 4 4 4 13 4 4 4 15 5 36 36 36 36 3 4 4 4 5 36 19 20 30 20 21 36 36 36 36 36 0 1 1 1 1 12 4 4 4 4 4 4 4 4
14 14 4 4 48 49 49 49 49 50 4 4 4 14 4 5 36 36 36 36 3 13 4 4 5 36 19 20 20 20 21 36 36 36 36 36 3 4 4 4 4 4 4 4 13 4 4 4 4 4
4 4 4 4 53 54 54 54 54 55 4 4 4 4 4 5 36 36 36 47 6 7 7 7 8 36 19 20 20 20 21 36 36 45 36 36 3 4 14 4 4 13 4 4 4 4 4 4 15 14
4 13 4 14 53 54 54 54 54 55 4 15 4 4 4 5 36 36 36 36 36 36 45 36 36 36 19 20 20 20 21 36 36 36 36 36 3 4 4 4 4 4 4 13 4 4 13 4 4 4
14 4 14 4 53 54 54 54 54 55 4 4 4 4 4 11 1 1 2 36 36 36 36 45 36 36 19 31 20 20 21 36 36 36 46 36 3 4 4 13 4 4 4 4 4 4 15 4 4 4
4 15 4 4 53 54 54 54 54 55 4 4 4 13 4 4 4 4 5 36 36 47 36 36 36 45 19 20 20 29 21 36 46 36 36 36 3 4 4 4 4 4 4 4 15 4 4 14 4 4
4 13 4 4 58 59 59 59 59 60 4 14 15 4 4 15 4 4 5 36 36 36 36 36 36 36 22 23 23 23 24 36 36 36 36 36 3 4 4 13 4 13 13 4 4 4 4 4 13 4
14 4 14 4 4 4 4 4 4 4 4 4 4 13 4 4 4 4 11 1 1 1 1 1 1 1 1 1 1 1 1 1 1 1 1 1 12 4 4 4 4 4 15 4 4 4 4 14 4 4
4 14 14 4 15 4 4 4 4 4 4 13 4 4 4 4 4 4 4 4 4 4 4 4 4 4 4 4 4 4 4 4 4 4 4 4 4 4 4 15 4 4 4 4 13 4 4 4 14 4
4 4 14 4 4 4 15 4 4 4 13 4 4 4 4 15 4 4 14 4 4 4 14 4 4 14 4 4 15 4 4 4 4 4 4 4 13 4 4 4 4 4 4 4 4 4 4 4 4 4
4 4 4 13 13 4 4 4 4 4 4 4 4 4 4 4 4 14 4 4 4 15 15 4 15 4 4 4 4 4 4 13 4 4 4 4 4 4 4 15 4 4 4 4 4 4 4 4 4 4
4 14 4 4 4 4 4 4 4 4 13 4 4 4 14 4 15 4 4 4 4 4 4 15 4 4 13 14 4 4 4 4 4 4 4 4 4 4 4 4 13 4 4 13 4 13 4 13 4 4
4 4 4 4 14 4 4 4 15 4 4 15 4 4 14 4 13 4 4 14 4 4 4 4 15 4 4 15 15 4 4 4 4 4 4 15 4 4 4 4 4 14 4 4 4 13 4 14 4 14
4 4 4 4 4 4 4 4 4 4 4 4 4 15 4 4 4 4 4 4 4 4 4 4 4 4 4 4 4 4 14 4 4 4 4 4 4 14 4 4 4 4 4 4 14 4 4 4 4 4
