1 1 1 1 1 1 1 1 1 1 1 1 1 1 1 1
1 10 8 8 8 8 8 8 8 8 8 8 8 8 11 1
1 6 17 18 18 19 0 0 0 0 0 0 0 0 5 1
1 6 20 21 21 22 0 0 0 0 0 0 0 0 5 1
1 6 20 30 21 22 0 0 0 0 0 0 0 0 5 1
1 6 23 27 32 22 0 0 0 0 0 0 0 0 5 1
1 6 0 20 21 28 18 18 18 18 19 0 0 0 5 1
1 6 0 20 21 21 31 21 21 21 22 0 0 0 5 1
1 6 0 23 24 24 24 24 24 24 25 0 0 0 5 1
1 6 0 0 0 0 0 0 0 0 0 0 0 0 5 1
1 12 3 3 3 3 3 3 3 3 3 3 3 3 13 1
1 1 1 1 1 1 1 1 1 1 1 1 1 1 1 1