1 1 14 16 1 16 1 1 1 1 1 1 1 1 1 1 1 1 1 1 1 1 1 1 1 1 1 1 1 1 1 1 16 1 1 1 1 1 1 1 1 1 14 1 1 1 1 1 1 1
1 14 1 1 1 1 1 1 16 1 1 16 1 1 1 16 1 1 1 1 1 1 1 14 1 1 15 1 1 1 1 1 15 1 1 1 16 15 1 16 14 1 1 15 1 14 1 1 1 1
1 16 1 1 1 1 1 1 1 1 1 1 14 1 1 1 1 1 16 1 1 1 16 1 1 1 1 1 1 1 14 1 1 1 1 1 1 1 1 1 1 1 1 1 1 1 1 1 1 1
1 1 10 8 8 8 11 1 1 1 1 1 1 1 1 1 1 1 1 1 14 1 1 15 1 10 8 8 8 8 8 8 8 8 8 8 8 8 8 8 8 8 8 8 11 1 1 16 14 1
1 14 6 0 0 0 5 1 1 1 16 1 14 1 1 1 1 1 16 1 1 1 1 1 1 6 17 18 18 18 18 18 18 18 18 18 18 18 18 18 19 0 0 0 7 11 1 1 1 1
1 1 6 0 0 0 5 1 1 1 1 1 1 1 1 1 1 16 1 1 1 1 1 1 1 6 20 31 21 21 21 21 21 21 32 21 21 21 21 31 22 0 0 0 0 5 1 16 1 1
16 1 6 0 0 0 5 14 16 1 1 1 1 16 14 1 1 1 15 16 1 14 1 16 1 6 20 21 32 21 21 30 21 21 21 21 21 32 21 21 22 0 0 0 0 5 1 1 14 1
1 1 12 3 3 3 13 1 1 1 1 1 1 15 1 1 1 1 1 1 1 1 1 1 1 6 23 24 24 24 24 24 24 24 24 24 24 27 21 21 22 0 0 0 0 5 1 1 15 1
1 1 1 1 1 1 1 1 1 1 1 1 1 1 1 14 15 1 1 1 1 16 1 1 1 12 3 3 3 4 0 0 0 0 0 0 0 20 21 21 22 0 0 0 0 5 1 16 1 1
14 1 1 1 1 1 1 1 1 1 16 1 1 1 1 1 1 16 1 1 1 1 1 1 1 1 1 1 1 6 0 0 0 0 0 0 0 20 21 30 22 0 0 0 0 5 1 14 1 1
1 1 1 1 1 14 1 1 1 1 15 1 1 16 1 1 1 1 1 16 1 14 1 1 1 1 1 1 1 6 0 0 0 0 0 0 0 20 21 21 22 0 0 0 0 5 1 1 1 1
1 14 1 1 16 16 1 1 1 15 1 1 1 14 1 1 1 1 1 1 1 1 1 1 1 1 1 1 1 6 0 0 0 0 0 0 0 20 21 21 22 0 0 0 0 5 1 1 16 1
1 1 15 1 1 1 1 1 1 16 1 1 15 1 1 1 1 1 1 15 1 10 8 8 8 8 8 8 8 9 0 0 0 0 0 0 0 20 21 32 22 0 0 0 0 5 1 1 1 1
16 1 1 1 1 1 1 1 1 1 1 1 1 1 1 16 1 15 1 1 1 6 0 0 0 0 0 0 0 0 0 0 0 0 0 0 0 20 21 21 22 0 0 0 0 5 1 15 14 1
1 16 1 1 1 16 1 1 1 1 1 16 1 1 1 1 1 1 1 1 1 6 0 0 0 0 0 0 0 0 0 0 0 0 0 0 0 20 21 21 22 0 0 0 0 5 1 1 1 1
1 14 1 1 1 1 1 16 1 1 1 15 1 1 1 14 1 1 1 1 1 6 0 0 0 0 0 0 0 0 0 0 0 0 0 0 0 20 32 21 22 0 0 0 0 5 1 1 1 1
1 1 1 1 14 1 1 16 1 15 1 1 1 1 1 1 1 1 1 1 1 6 0 0 0 0 0 0 0 0 0 0 0 0 0 0 0 20 21 21 22 0 0 0 0 5 1 16 1 1
15 1 1 1 15 1 1 1 1 1 1 1 1 10 8 8 8 8 8 8 8 9 0 0 0 0 0 17 18 18 18 18 18 18 18 18 18 29 21 21 22 0 0 0 0 5 1 1 1 14
1 16 1 1 1 1 1 1 1 1 1 1 1 6 0 0 0 0 0 0 0 0 0 0 0 0 0 20 21 21 21 21 21 31 21 21 21 21 30 21 22 0 0 0 0 5 1 1 1 1
1 1 1 1 16 1 1 1 1 1 1 1 1 6 0 0 0 0 0 0 0 0 0 0 0 0 0 20 21 30 21 21 21 21 21 21 21 21 21 21 22 0 0 0 0 5 1 15 1 16
1 1 1 1 14 1 1 10 8 8 8 8 8 9 0 0 0 0 0 0 0 0 0 0 0 0 0 20 21 21 26 24 24 24 24 24 24 24 24 24 25 0 0 0 0 5 1 1 1 1
1 1 1 1 1 1 1 6 0 0 0 0 0 0 0 0 0 0 0 0 0 0 0 0 0 0 0 20 21 32 22 0 0 0 0 0 0 0 0 0 0 0 0 0 0 5 1 1 1 1
1 1 1 1 1 1 15 6 0 0 0 0 0 0 0 0 0 0 0 0 0 0 0 0 0 0 0 20 21 21 22 0 0 0 0 0 0 0 0 0 0 0 0 0 0 5 1 1 1 14
1 1 1 1 1 1 1 6 0 0 0 0 0 0 0 0 0 0 0 0 0 0 0 0 0 0 0 20 32 21 22 0 0 0 0 0 0 0 0 0 0 0 0 0 0 5 1 1 16 1
16 14 14 1 16 1 1 6 0 17 18 18 18 18 18 18 18 18 18 19 0 0 0 0 0 0 0 20 21 21 22 0 0 0 0 0 0 0 0 0 0 0 0 0 0 5 1 15 1 1
1 1 1 1 15 1 1 6 0 20 32 21 21 21 21 21 21 21 31 22 0 0 0 0 0 0 0 20 21 30 22 0 0 0 0 0 0 0 0 0 0 0 0 0 0 5 14 1 1 1
1 1 1 1 1 1 1 6 0 20 21 21 21 21 21 30 21 21 21 28 18 18 18 18 18 18 18 29 21 21 22 0 0 0 0 0 0 0 0 0 0 0 0 0 0 5 1 1 1 1
1 1 1 1 1 1 1 6 0 23 24 24 24 24 24 24 27 21 21 21 21 30 21 21 21 21 21 21 21 21 28 18 18 18 18 18 18 18 19 0 0 0 0 0 0 5 1 16 1 1
1 1 1 14 1 1 1 6 0 0 0 0 0 0 0 0 20 32 21 21 21 21 21 21 32 21 21 30 21 21 21 21 21 21 32 21 21 21 22 0 0 0 0 0 0 5 1 15 1 1
16 1 1 1 1 16 1 6 0 0 0 0 0 0 0 0 23 24 24 24 24 24 24 24 24 24 27 21 21 31 26 24 24 24 24 24 27 21 22 0 0 0 0 0 0 5 1 1 1 1
1 1 15 1 1 1 1 12 3 3 3 3 3 3 3 4 0 0 0 0 0 0 0 0 0 0 20 21 21 21 22 0 0 0 0 0 20 21 22 0 0 0 0 0 0 5 1 1 1 1
1 14 1 1 1 14 1 1 1 1 1 1 1 1 14 6 0 0 0 0 0 0 0 0 0 0 20 21 21 21 22 0 0 0 0 0 20 31 28 18 18 18 19 0 0 5 14 1 16 1
1 1 1 1 1 1 1 1 14 1 14 16 1 1 1 6 0 0 0 0 0 0 0 0 0 0 20 32 21 21 22 0 0 0 0 0 20 21 21 30 21 31 22 0 0 5 1 1 1 1
1 14 1 16 1 1 16 1 1 1 1 1 15 1 1 6 0 0 0 0 2 3 3 3 4 0 20 21 31 21 22 0 0 0 0 0 23 24 24 24 24 24 25 0 0 5 1 1 14 1
14 1 1 1 1 1 15 1 1 15 1 1 1 1 1 6 0 0 0 0 5 1 1 1 6 0 20 21 21 21 22 0 0 0 0 0 0 0 0 0 0 2 3 3 3 13 1 16 15 1
1 16 1 14 1 1 1 1 1 1 1 1 14 1 1 6 0 0 0 0 5 1 15 1 6 0 20 21 21 30 22 0 0 0 0 0 0 0 0 0 0 5 1 1 1 1 1 1 1 1
1 1 14 1 1 1 1 1 1 1 16 1 1 1 15 6 0 0 0 0 5 1 1 1 6 0 20 21 30 21 22 0 0 0 0 0 2 3 3 3 3 13 1 1 1 1 1 1 1 1
14 14 1 1 10 8 8 8 8 11 1 1 1 14 1 6 0 0 0 0 5 16 1 1 6 0 20 21 21 21 22 0 0 0 0 0 5 1 1 1 1 1 1 1 16 1 1 1 1 1
1 1 1 1 6 0 0 0 0 5 1 1 1 1 1 6 0 0 0 0 7 8 8 8 9 0 20 21 21 21 22 0 0 0 0 0 5 1 14 1 1 16 1 1 1 1 1 1 15 14
1 16 1 14 6 0 0 0 0 5 1 15 1 1 1 6 0 0 0 0 0 0 0 0 0 0 20 21 21 21 22 0 0 0 0 0 5 1 1 1 1 1 1 16 1 1 16 1 1 1
14 1 14 1 6 0 0 0 0 5 1 1 1 1 1 12 3 3 4 0 0 0 0 0 0 0 20 31 21 21 22 0 0 0 0 0 5 1 1 16 1 1 1 1 1 1 15 1 1 1
1 15 1 1 6 0 0 0 0 5 1 1 1 16 1 1 1 1 6 0 0 0 0 0 0 0 20 21 21 32 22 0 0 0 0 0 5 1 1 1 1 1 1 1 15 1 1 14 1 1
1 16 1 1 12 3 3 3 3 13 1 14 15 1 1 15 1 1 6 0 0 0 0 0 0 0 23 24 24 24 25 0 0 0 0 0 5 1 1 16 1 16 16 1 1 1 1 1 16 1
14 1 14 1 1 1 1 1 1 1 1 1 1 16 1 1 1 1 12 3 3 3 3 3 3 3 3 3 3 3 3 3 3 3 3 3 13 1 1 1 1 1 15 1 1 1 1 14 1 1
1 14 14 1 15 1 1 1 1 1 1 16 1 1 1 1 1 1 1 1 1 1 1 1 1 1 1 1 1 1 1 1 1 1 1 1 1 1 1 15 1 1 1 1 16 1 1 1 14 1
1 1 14 1 1 1 15 1 1 1 16 1 1 1 1 15 1 1 14 1 1 1 14 1 1 14 1 1 15 1 1 1 1 1 1 1 16 1 1 1 1 1 1 1 1 1 1 1 1 1
1 1 1 16 16 1 1 1 1 1 1 1 1 1 1 1 1 14 1 1 1 15 15 1 15 1 1 1 1 1 1 16 1 1 1 1 1 1 1 15 1 1 1 1 1 1 1 1 1 1
1 14 1 1 1 1 1 1 1 1 16 1 1 1 14 1 15 1 1 1 1 1 1 15 1 1 16 14 1 1 1 1 1 1 1 1 1 1 1 1 16 1 1 16 1 16 1 16 1 1
1 1 1 1 14 1 1 1 15 1 1 15 1 1 14 1 16 1 1 14 1 1 1 1 15 1 1 15 15 1 1 1 1 1 1 15 1 1 1 1 1 14 1 1 1 16 1 14 1 14
1 1 1 1 1 1 1 1 1 1 1 1 1 15 1 1 1 1 1 1 1 1 1 1 1 1 1 1 1 1 14 1 1 1 1 1 1 14 1 1 1 1 1 1 14 1 1 1 1 1
